1111111111111111111111111111111111
1C1C1C00C00C100C100C100C100C1000C1
1P10101011100C100C100C1CCC100C1001
101010101E111111111111111111111101
1C0C0C1C100C00C00C00C00C00C00C00C1
1111111111111111111111111111111111