1111111111111111
10010000000C1001
1000011111001001
1P0011E000001001
1111111111111111